___###___
#### ####
#W  W  W#
#### ####
___###___