#####_
#  ###
#    #
###W##
#    #
## ###
_###__