#####
#   #
###W#
#   #
#W###
#   #
#####