#########
#W##    #
#    ## #
#       #
##W## ###
_####W#__
____###__
