_#####_
## # ##
#W # W#
## # ##
#  #  #
#W # W#
#######