#######
#  #  #
#W   W#
#  #  #
#######