#######
#     #
#W#W#W#
#     #
#######