_#####_
## # ##
#     #
##W#W##
#  #  #
## # ##
_#####_